NO textures/matrix.xpm
SO textures/matrix.xpm
WE textures/matrix.xpm
EA textures/matrix.xpm

F 0,0,0
C 0,0,0

111111111111111111111
101000001000000000001
101111111111111111111
101101111000000000N11
111111111111111111111
