NO textures/N.xpm
SO textures/S.xpm
WE textures/W.xpm
EA textures/E.xpm

F 130,200,229
C 0,0,0

    1111111111111111111
111110001000000000001
10001110101000000000111
1N1001000010000010001
100000000000000000001
100000000000000000001
100000000000000000001
1000000000000000001
10000001D10000000001
100000000000000001
100000000000000000001
100000000000000000001
100000101000101000001
111111111111111111111
