NO textures/matrix.xpm
SO textures/matrix.xpm
WE textures/matrix.xpm
EA textures/matrix.xpm

F 0,250,250
C 250,250,250

111111111111111111111
1N0000001000000000001
100010101010000000001
100001000010000010001
100000000000000000001
100000000000000000001
100000000000000000001
100000000000000000001
100000000000000000001
100000000000000000001
100000000000000000001
100000000000000000001
100000101000101000001
111111111111111111111
