NO textures/wolfenstein/grey_stone.xpm
SO textures/wolfenstein/purple_stone.xpm
WE textures/wolfenstein/red_brick.xpm
EA textures/wolfenstein/wood.xpm

F 1,1,1
C 225,255,255

        1111111111111111111111111
        1000000000110000000000001
        1011000001110000000000001
        100100000000000000000000111111111111111111111
111111111011000001110000000000001
10000000001100000111011111111111111111111111111111111111111
11110111111111011100000010001
11110111111111011101010010001
11000000110101011100000010001
10000000000000001100000010001
10000000000000001101010010001
11000001110101011111011110N0111
11110111 1110101 101111010001
11111111 1111111 111111111111
1
1
1
1
